R 1200 800
NO ./srcs/arcenciel.xpm



SO         				                    ./srcs/purplestone.xpm
	WE                                                          ./srcs/greystone.xpm
   EA    	./srcs/redbrick.xpm
S ./srcs/barrel.xpm
F 0,111,0
C 50,0,150

        1111111111111111111111111
        100S000000010100000000001
        1011000001110000002000001
        1001000000000000000000001
111111111011000001110000000000001
100000000011000001110111111111111
11110111111111011100000010001
11110111111111011101010010001
11000000110101011100000000001
10002000000000001100000010201
10000000000000001101010010201
1100000111010101111101111010111
11110111 1110101 101111010001
11111111 1111111 111111111101
                           1
